The Art of Loving	Erich Fromm
The Social Contract	Jean Jacques Rousseau
Civilisation	John Armstrong
The Communist Manifesto	Karl Marx
Pensieri	Leopardi
Culture and Anarchy	Matthew Arnold
The Needs of Strangers	Michael Ignatieff
They F You Up	Oliver James
The Dying Animal	Philip Roth
Couch Fiction	Philippa Perry
The Symposium	Plato
What should I do with my Life	Po Bronson
Camera Lucida	Roland Barthes
Letters from a Stoic	Seneca
An Intimate History of Humanity	Theodor Zeldin
An Intimate History of Humanity	Theodor Zeldin
Man and Superman	George Bernard Shaw
Coriolanus	William Shakespeare
Extraordinary Popular Delusions and the Madness of Crowds	Charles Mackay
Freedom Feminism: Its Surprising History and Why It Matters Today	Christina Hoff Sommers
The New Digital Age	Eric Schmidt
The Little Prince	Antoine de Saint-Exupery
Notes of a Native Son	James Baldwin
Trespassing Across America	Ken Ilgunas
This Changes Everything	Naomi Klein
Private Empire	Steve Coll
Electric Light	Seamus Heaney
The Prophets	Abraham Joshua Heschel
The End of the Free Market	Ian Bremmer
The Party	Richard McGregor
Globalizing Capital	Barry Eichengreen
One World	Peter Singer
The Mind's I	Douglas Hofstadter
The Rational Optimist	Matt Ridley
The Really Hard Problem: Meaning in a Material World	Owen Flanagan
The Ancestor's Tale	Richard Dawkins
Operating Manual for Spaceship Earth	Buckminster Fuller
Exodus in The Five Books of Moses	Everett Fox
The Turbulent Mirror	John Briggs
The Origin of Consciousness in the Breakdown of the Bicameral Mind	Julian Jaynes
Technopoly: The Surrender of Culture to Technology	Neal Postman
Chaos and Cyber Culture	Timothy Leary
The Diamond in Your Pocket	Gangaji
A Course in Miracles	Helen Schucman
365 Nirvana Here And Now	Josh Baran
Be As You Are	Sri Ramana Maharshi
Tales from the Expat Harem	Anastasia Ashman 
Rethinking Modernity and National Identity in Turkey	Sibel Bozdogan
Ignition!	John Clark
The Lord of the Rings	JRR Tolkien
Does Technology Drive History? The Dilemma of Technological Determinism 	Merritt Roe Smith
Stringer	Anjan Sundaram
The Director	David Ignatius
National Insecurity	David Rothkopf
Lost for Words	Edward St. Aubyn
The Second Machine Age	Erik Brynjolfsson
Good Hunting: An American Spymaster's Story	Jack Devine
The Universe edited	John Brockman
The Fourth Revolution	John Micklethwait & Adrian Wooldridge
The Righteous Mind	Jonathan Haidt
The Intel Trinity	Michael Malone
The Mantle of Command: FDR at War, 1941-1942	Nigel Hamilton
Zero to One	Peter Thiel
The Rule of Nobody	Philip K. Howard
Temptations of Power: Islamists and Illiberal Democracy in a New Middle East	Shadi Hamid
The Better Angels of Our Nature	Steven Pinker
Capital in the Twenty-First Century	Thomas Piketty
Excellent Sheep: The Miseducation of the American Elite and the Way to a Meaningful Life	William Deresiewicz
Influence: The Psychology of Persuasion	Bob Cialdini
The Innovator's Dilemma	Clayton Christensen
Uncommon Genius	Denise Shekerjian
Crossing the Chasm	Geoffrey Moore
The Hockey Handbook	Lloyd Percival
Inevitable Illusions	Massimo Piattelli-Palmarini
The Chicago Manual of Style	University of Chicago
Great Expectations	Charles Dickens
Tarzan of the Apes	Edgar Rice Burroughs
The Story of Doctor Dolittle	Hugh Lofting
The Miracle of Life	Merce Parramon
One Pair of Hands	Monica Dickens
The Rime of the Ancient Mariner	Samuel Taylor Coleridge
Don't Sleep, There Are Snakes	Daniel L. Everett
We, the Navigators	David Lewis
How Much Is Enough?	Robert Skidelsky
DAEMON	Leinad Zeraus
The Crisis of Capitalist Democracy	Richard Posner
The Hockey Stick Illusion	Andrew Montford
What You Want	Constantine Phipps
The Vital Question: Energy, Evolution, and the Origins of Complex Life	Nick Lane
The Weather Experiment	Peter Moore
Arcadia	Tom Stoppard
The Sunday Philosophy Club	Alexander McCall Smith
The Dream of Reason	Anthony Gottlieb
Probability, Random Variables, and Stochastic Processes	Athanasios Papoulis
The Paradox of Choice	Barry Schwartz
The (Mis)behavior of Markets	Benoit Mandelbrot
Confessions of a Philosopher	Bryan Magee
The Making of a Philosopher	Colin McGinn
Statistical Models	David Freeman
Critical Phenomena 	Didier Sornette
Why Stock Markets Crash	Didier Sornette
The Wisdom Paradox	Elkhonon Goldberg
Good Calories, Bad Calories	Gary Taubes
The Discovery of France	Graham Robb
Intellectuals in the Middle Ages	Jacques Le Goff
The Science of Conjecture	James Franklin
Financial Derivatives	Jamil Baz
The Mind Doesn't Work That Way	Jerry Fodor
I Think Therefore I Laugh	John Allen Paulos
The Hour Between Dog & Wolf	John Coates
Straw Dogs	John Gray
Body by Science	John Little
Thinking and Deciding	Jonathan Baron
The Status Syndrome	Michael Marmot
No Bull	Michael Steinhardt
Modern Aramaic-English/English-Modern Aramaic Dictionary & Phrasebook: Assyrian/Syriac	Nicholas Awde
A History of the Mind	Nicholas Humphrey
How Nature Works: The Science of Self-Organized Criticality	Per Bak
A Few Lessons from Sherlock Holmes	Peter Bevelin
A Guide to Econometrics	Peter Kennedy
Mapping the Mind	Rita Carter
Why Everyone (Else) Is a Hypocrite	Robert Kurzban
The Blank Slate	Steven Pinker
Mean Genes	Terry Burnham
Kant and the Platypus	Umberto Eco
Tyranny of Experts	William Easterly
The History of the Decline and Fall of the Roman Empire	Edward Gibbon
At Swim-Two-Birds	Flann O'Brien
Gold and Iron	Fritz Stern
The Private Memoirs and Confessions of a Justified Sinner	James Hogg
The Last Days of Mankind	Karl Kraus
1984	George Orwell
A People's History of the United States	Howard Zinn
A Preponderance of Power: National Security, Truman Administration and the Cold War	Melvyn Leffler
A Theory of Power	Jeff Vail
A Thousand Days: John F. Kennedy in the White House	Arthur M. Schlesinger
Accumulation and Power: Economic History of the United States	Richard B. DuBoff
After Such Knowledge, What Forgiveness? My Encounters With Kurdistan	Jonathan Randal
Al-Qaeda: The True Story of Radical Islam	Jason Burke
American Foreign Policy	Henry A. Kissinger
Anarcho-Syndicalism: Theory and Practice	Rudolf Rocker
Arguing About War	Michael Walzer
Bad Samaritans	Ha-Joon Chang
Bakunin on Anarchism	Sam Dolgoff
Between Serb and Albanian: A History of Kosovo	Miranda Vickers
Between the Lines	Tikva Honig-Parnass
Beyond the Hoax: Science, Philosophy and Culture	Alan Sokal
Big Story	Peter Braestrup
Bitter Fruit: The Untold Story of the American Coup in Guatemala	Stephen Schlesinger
Business as a System of Power	Robert A. Brady
Business as Usual	Paul Mattick
Cambodia 1975 - 1982	Michael Vickory
Capital	Karl Marx
Churchill	Clive Ponting
Collateral Damage: The New World Order at Home and Abroad	Cynthia Peters
Collusion Across the Jordan: King Abdullah, the Zionist Movement and the Partition of Palestine	Avi Shlaim
Condemned to Repetition: United States and Nicaragua	Robert A. Pastor
Conflicting Missions: Havana, Washington, Pretoria	Piero Gleijeses
Confronting the Third World: United States Foreign Policy, 1945-1980	Gabriel Kolko
Culture, Inc.: The Corporate Takeover of Public Expression	Herbert I. Schiller
Danger and Survival: Choices About the Bomb in the First Fifty Years	McGeorge Bundy
Demonstration Elections: United States Staged Elections in the Dominican Republic, Vietnam and El Salvador	Edward Herman
Don't Mourn, Balkanize!	Andrej Grubacic
East Timor: The Price of Freedom	John G. Taylor
Economic Liberalism and Under-development	Frederick Clairmont
Emergence of a Free Press	Leonard W. Levy
Empire of Fortune	Francis Jennings
European Empires from Conquest to Collapse, 1815-1960	V.G. Kiernan
Exporting Democracy: The United States and Latin America	Abraham F. Lowenthal
Expulsion of the Palestinians: The Concept of "Transfer" in Zionist Political Thought, 1882-1948	Nur Masalha
Facing West: Metaphysics of Indian-hating and Empire-building	Richard Drinnon
Fashionable Nonsense: Postmodern Intellectuals' Abuse of Science	Alan Sokal
Field Notes on Democracy	Arundhati Roy
Granny Made Me an Anarchist	Stuart Christie
How America Gets Away with Murder	Michael Mandel
Human Rights and United States Policy Toward Latin America	Lars Schoultz
Humanitarian Intervention: The United Nations in an Evolving World Order	Sean D. Murphy
Image and Reality of the Israel-Palestine Conflict	Norman G. Finkelstein
In Retrospect	Robert S. McNamara
In the Name of Democracy: U.S. Policy Toward Latin America in the Reagan Years	Thomas Carothers
Inevitable Revolutions: United States in Central America	Walter Lafeber
Instruments of Statecraft: U.S. Guerrilla Warfare, Counterinsurgency, and Counter-Terrorism, 1940-1990	Michael McClintock
Intervention: How America Became Involved in Vietnam	George Kahin
Israel's Border Wars, 1949-1956: Arab Infiltration, Israeli Retaliation, and the Countdown to the Suez War	Benny Morris
John Quincy Adams and American Global Empire	William Earl Weeks
Just the Facts: A Civilian's Guide to U.S. Defense and Security Assistance to Latin America and the Caribbean	Joy Olson
Kennedy's Quest for Victory: American Foreign Policy, 1961-1963	Thomas G. Paterson
Killing Hope	William Blum
Last Reflections on a War: Bernard B.Fall's Last Comments on Vietnam	Bernard B. Fall
Mark Twain's Weapons of Satire: Antiimperialist Writings on the Philippine-American War	Mark Twain
Nicaragua: The Price of Intervention : Reagan's Wars Against the Sandinistas	Peter Kornbluh
No Gods, No Masters: An Anthology of Anarchism	Daniel Guerin
Out of Control: The Story of the Reagan Administration's Secret War in Nicaragua, the Illegal Arms Pipeline, and the Contra Drug Connection	Leslie Cockburn
Panic Rules: Everything You Need to Know about the Global Economy	Robin Hahnel
Peace Denied: United States, Vietnam and the Paris Agreement	Gareth Porter
Politicide: Ariel Sharon's War Against the Palestinians	Baruch Kimmerling
Politics of Health Policy: The U.S.Reforms, 1980-93	Vicente Navarro
Power Without Responsibility: Press, Broadcasting and the Internet in Britain	Jean Seaton
Qaddafi and the United States since 1969	Edward Haley
Reagan Versus the Sandinistas: Undeclared War on Nicaragua	Thomas W. Walker
Reflections on the Cuban Missile Crisis	Raymond Garthoff
Requiem for Revolution: United States and Brazil, 1961-69	Ruth Leacock
Revolution and Civil War in Spain	Pierre Broue
Right Turn: The Decline of the Democrats and the Future of American Politics	Thomas Ferguson
Ruthless Criticism: New Perspectives in US Communications History	Robert McChesney
Safe for Democracy: The Anglo-American Response to Revolution, 1913-1923	Lloyd C. Gardner
Selling Free Enterprise: The Business Assault on Labor and Liberalism, 1945-60	Elizabeth Fones-Wolf
Spain and the Great Powers, 1936 to 1941	Dante Anthony Puzzo
Spanish Cockpit: An Eyewitness Account of the Spanish Civil War	Franz Borkenau
State Terrorism and the United States	Frederick Gareau
Supremacy and Oil: Iraq, Turkey and the Anglo-American World Order, 1918-30	William Stivers
Taking the Risk out of Democracy: Corporate Propaganda Versus Freedom and Liberty	Alex Carey
Talking to the Enemy	Scott Atran
The ABCs of Political Economy	Robin Hahnel
The Age of Terror: America and the World After September 11	Strobe Talbott
The Altenberg 16	Susan Mazur
The American Occupation of Japan: The Origins of the Cold War in Asia	Michael Schaller
The Anarchist Collectives	Sam Dolgoff
The Anatomy of the Nuremberg Trials	Telford Taylor
The Birth of Israel	Simha Flapan
The CIA and American Democracy	Rhodri Jeffreys-jones
The CIA: Forgotten History	William Blum
The Crisis of Democracy	Samuel Huntington
The Deaths of Others	John Tirman
The Discovery of India	Jawaharlal Nehru
The Grand Camouflage: The Communist Conspiracy in the Spanish Civil War	Burnett Bolloten
The Great Transformation: The Political and Economic Origins of Our Time	Karl Polanyi
The Industrial Worker, 1840-1860	Norman Ware
The Iran-Contra Connection: Secret Teams and Covert Operations in the Reagan Era	Jane Hunter
The Kennedy Tapes. Inside the White House During the Cuban Missile Crisis	Ernest R. Ma
The Limits of State Action	Wilhelm von Humboldt
The Long Peace: Inquiries into the History of the Cold War	John Lewis Gaddis
The Making of the Arab-Israeli Conflict, 1947-1951	Ilan Pappe
The Marshall Plan: America, Britain and the Reconstruction of Western Europe, 1947-1952	Michael J. Hogan
The New Intifada: Resisting Israel's Apartheid	Roane Carey
The Origins of the Korean War: Volume II The Roaring of the Cataract 1947-1950	Bruce Cumings
The Politics of Heroin: CIA Complicity in the Global Drug Trade, Afghanistan, Southeast Asia, Central America, Columbia	Alfred W. McCoy
The Price of Power: Kissinger in the Nixon White House	Seymour M. Hersh
The Punishment of Gaza	Gideon Levy
The Quality of Mercy: Cambodia, Holocaust and Modern Conscience	William Shawcross
The Reagan Aministration And Nicaragua	James Petras
The Real Terror Network: Terrorism in Fact and Propaganda	Edward Herman
The Record of the Paper: How the "New York Times" Misreports US Foreign Policy	Richard A. Falk
The Rise and Fall of the Bulgarian Connection	Edward Herman
The Road to OPEC: United States Relations with Venezuela, 1919-1976	Stephen G. Rabe
The State of the World's Children: 1997	UNICEF
The Transformation of American Law 1870 - 1960	Morton J. Horwitz
The Uncensored War: The Media and Vietnam	Daniel C. Hallin
The Uncensored War: The Media and Vietnam	Daniel Hallin
The United States and Fascist Italy, 1922-1940	David F. Schmitz
The United States and the Origins of the Cuban Revolution	Jules R Benjamin
The Uses of Haiti	Paul Farmer
The Verso Book of Dissent	Andrew Hsiao
The Wealth of Nations	Adam Smith
U.S.Policy Toward Economic Nationalism in Latin America, 1917-29	Michael L. Krenn
Understanding Capitalism	Douglas Dowd
Viet Cong: The Organization and Techniques of the National Liberation Front of South Vietnam	Douglas Pike
War with Iraq: Costs, Consequences, and Alternatives	Carl Kaysen
Washington's War on Nicaragua	Holly Sklar
Weakness and Deceit: America and El Salvador's Dirty War	Raymond Bonner
Web Of Deceit: Britain's Real Foreign Policy: Britain's Real Role in the World	Mark Curtis
Whose Crisis? Whose Future?	Susan George
Workers' Councils	Anton Pannekoek
Worlds in Collision	Ken Booth
Or I’ll Dress You in Mourning	Dominique Lapierre
Tropic of Cancer	Henry Miller
The General Theory of Employment, Interest and Money	JM Keynes
Atlas Shrugged	Ayn Rand
The Man Who Sold the Moon and Orphans of the Sky	Robert Heinlein
The Descent of Man	Charles Darwin
Final Exit	Derek Humphrey
The Methods of Ethics	Henry Sidgwick
Pride & Prejudice	Jane Austen
In the Shadow of Man	Jane Goodall
Humanity	Jonathan Glover
On Liberty	JS Mill
Silent Spring	Rachel Carson
The Betrothed	Alessandro Manzoni
The Lord	Romano Guardini
The Story of a Soul	St Therese de Lisieux
Samarkand	Amin Maalouf
The Secret Life of Saeed the Pessoptimist	Emile Habiby 
The Day the Leader Was Killed	Naguib Mahfouz
The Demon-Haunted World: Science as a Candle in the Dark	Carl Sagan
Intuition Pumps and Other Tools for Thinking	Daniel Dennett
Red Strangers	Elspeth Huxley
Splendid Isolation	George Gaylord Simpson
The Ant and the Peacock	Helena Cronin
Why Evolution Is True	Jerry Coyne
Pluto's Republic	Peter Medawar
Uncle Fred in the Springtime	PG Wodehouse
Evolution of Cooperation	Robert Axelrod
Attack of the Theocrats	Sean Faircloth
Narrow Roads of Gene Land	W.D. Hamilton
The Bloody Chamber	Angela Carter
Nights at the Circus	Angela Carter
In Custody	Anita Desai
The Nonexistent Knight	Italo Calvino
Ulysses	James Joyce
Pedro Páramo	Juan Rulfo
The Sirens of Titan 	Kurt Vonnegut
The Master and Margarita	Mikhail Bulgakov
The Strange Case of Dr. Jekyll and Mr. Hyde	Robert Louis Stevenson
Riddley Walker	Russell Hoban
Beowulf	Seamus Heaney
Ideas and Opinions	Albert Einstein
Out of My Later Years	Albert Einstein
The Doors of Perception and Heaven and Hell	Aldous Huxley
The Perennial Philosophy	Aldous Huxley
The Gulag Archipelago	Aleksandr I. Solzhenitsyn
The Day of the Barbarians	Alessandro Barbero
Self-Deception Unmasked	Alfred Mele
Jesus: A Life	AN Wilson
Paul	AN Wilson
The Legacy of Jihad	Andrew Bostom
The Noonday Demon	Andrew Solomon
The Road to Martyrs' Square	Anne Marie Oliver
Descartes Error	Antonio Damasio
Looking for Spinoza	Antonio Damasio
The Nature of the Physical World	AS Eddington
Ending Aging	Aubrey de Grey
Infidel	Ayaan Hirsi Ali
Nomad	Ayaan Hirsi Ali
The Caged Virgin	Ayaan Hirsi Ali
The Paradox of Choice	Barry Schwartz
The Significance of Philosophical Scepticism	Barry Stroud
Misquoting Jesus: The Story Behind Who Changed the Bible and Why	Bart Ehrman
Ethics	Baruch Spinoza
The Skeptic Way	Benson Mates
The Crisis of Islam	Bernard Lewis
Autobiography	Bertrand Russell
Religion and Science	Bertrand Russell
The Problems of Philosophy	Bertrand Russell
Why I Am Not a Christian and Other Essays on Religion and Related Subjects	Bertrand Russell
Mindfulness in Plain English	Bhante Henepola Gunaratana
Among the Thugs	Bill Buford
Influence: The Psychology of Persuasion	Bob Cialdini
The Cleanest Race	BR Myers
The Fabric of the Cosmos: Space, Time, and the Texture of Reality	Brian Greene
Zen at War	Brian Victoria
While Europe Slept	Bruce Bawer
Fundamentals of Human Neuropsychology	Bryan Kolb
The Demon-Haunted World: Science as a Candle in the Dark	Carl Sagan
Extraordinary Popular Delusions and the Madness of Crowds	Charles Mackay
Commissurotomy, Consciousness, and Unity of Mind	Charles Marks
Tracing Back the Radiance: Chinul’s Korean Way of Zen	Chinul
The Aquariums of Pyongyang	Chol-hwan Kang
The Encyclopedia of Psychoactive Plants	Christian Ratsch
Hitch-22	Christopher Hitchens
Letters to a Young Contrarian	Christopher Hitchens
The Enemy	Christopher Hitchens
Why Orwell Matters	Christopher Hitchens
The Oxford Companion to the Body	Colin Blakemore
The Mysterious Flame	Colin McGinn
Predictably Irrational: The Hidden Forces that Shape Our Decisions	Dan Ariely
10% Happier	Dan Harris
Breaking the Spell	Daniel Dennett
Darwin’s Dangerous Idea: Evolution and the Meanings of Life	Daniel Dennett
Freedom Evolves	Daniel Dennett
The Intentional Stance	Daniel Dennett
Stumbling on Happiness	Daniel Gilbert
Hitler's Willing Executioners	Daniel Jonah Goldhagen
Judgment Under Uncertainty	Daniel Kahneman
Memory, Brain, and Belief	Daniel Schacter
Voodoo Histories	David Aaronovitch
The End of Illness	David Agus
Dialogues Concerning Natural Religion	David Hume
The Nature of Mind	David Rosenthal
The Abandonment of the Jews	David S. Wyman
The Conscious Mind: In Search of a Fundamental Theory	DJ Chalmers
Animal Minds	Donald Griffin
The Mind's I	Douglas Hofstadter
This Republic of Suffering	Drew Gilpin Faust
The History of the Decline and Fall of the Roman Empire	Edward Gibbon
Crowds and Power	Elias Canetti
The Executive Brain	Elkhonon Goldberg
Suicide	Emile Durkheim
Principles of Neural Science	Eric Kandel
The Second Machine Age	Erik Brynjolfsson
The Denial of Death	Ernest Becker
Behavior in Public Places	Erving Goffman
The Presentation of Self in Everyday Life	Erving Goffman
My View of the World	Erwin Schrodinger
What Is Life?	Erwin Schrodinger
Cities on a Hill	F. Scott Fitzgerald
The Future of Freedom	Fareed Zakaria
A Delusion of Satan	Frances Hill
Philosophical Dictionary	Francois Voltaire
When the Air Hits Your Brain	Frank T. Vertosick Jr.
Imagined Worlds	Freeman Dyson
Free Will	Gary Watson
Stripping the Gurus	Geoffrey Falk
Breakdown of Will	George Ainslie
Persons And Places	George Santayana
Scepticism And Animal Faith	George Santayana
Atheism	George Smith
A Universe Of Consciousness How Matter Becomes Imagination	Gerald Edelman
Second Nature: Brain Science and Human Knowledge	Gerald Edelman
The End of Days	Gershom Gorenberg
The Religion of Jesus the Jew	Geza Vermes
Eichmann in Jerusalem	Hannah Arendt
Omens of Millennium	Harold Bloom
The Book of J	Harold Bloom
My Lunches with Orson	Henry Jaglom
The Mental and the Physical: The Essay and a Postscript	Herbert Feigl
Self-Deception	Herbert Fingarette
An Anatomy of Thought	Ian Glynn
Why I Am Not a Muslim	Ibn Warraq
Critique of Pure Reason 	Immanuel Kant
Kant: Ethical Philosophy: Grounding for the Metaphysics of Morals, and, Metaphysical Principles of Virtue, with, "On a Supposed Right to Lie Because of Philanthropic Concerns"	Immanuel Kant
Without Sanctuary	James Allen
The Life of Samuel Johnson	James Boswell
Honor	James Bowman
The Psychopath Inside	James Fallon
The Golden Bough	James Frazer
Isaac Newton	James Gleick
The Mysterious Universe	James Jeans
Examined Lives	James Miller
Collapse: How Societies Choose to Fail or Succeed	Jared Diamond
You Are Not a Gadget: A Manifesto	Jaron Lanier
The Illustrated Jesus Through the Centuries	Jaroslav Pelikan
Storming Heaven: LSD and the American Dream	Jay Stevens
The Diving Bell and the Butterfly	Jean-Dominique Bauby
Being and Nothingness	Jean-Paul Sartre
Why Evolution Is True	Jerry Coyne
The Destructive Power of Religion	JH Ellens
The Awakening of Intelligence	Jiddu Krishnamurti
My Stroke of Insight	Jill Bolte Taylor
Slouching Toward Bethlehem	Joan Didion
The Year of Magical Thinking	Joan Didion
Erwin Schrodinger and the Quantum Revolution 	John Gribbin
Game Change	John Heilemann
Self-Liberation through Seeing with Naked Awareness	John Myrdhin Reynolds
Knowledge, Possibility, and Consciousness	John Perry
A Theory of Justice	John Rawls
Justice as Fairness	John Rawls
The Construction of Social Reality 	John Searle
The Rediscovery of the Mind	John Searle
Three Cups of Deficit	Jon Krakauer
Under the Banner of Heaven	Jon Krakauer
The Psychopath Test	Jon Ronson
Thinking and Deciding	Jonathan Baron
Humanity	Jonathan Glover
Passage to Juneau	Jonathan Raban
The Fate of the Earth and The Abolition 	Jonathan Schell
The Unfinished Twentieth Century	Jonathan Schell
The Experience of Insight	Joseph Goldstein
Synaptic Self	Joseph LeDoux
Utilitarianism	JS Mill
On Liberty	JS Mill
The Open Society and Its Enemies, Vol. 1	Karl Popper
The Flight of the Garuda	Keith Dowman
The Cambridge Handbook of Thinking and Reasoning	Keith Holyoak
American Theocracy	Kevin Phillips
The Nature of Explanation	KJW Craik
Experiments in Ethics	Kwame Anthony Appiah
Breath by Breath	Larry Rosenberg
Righteous	Lauren Sandler
Going Clear	Lawrence Wright
The Suicide of Reason	Lee Harris
Dark Ages	Lee McIntyre
Challenging Nature	Lee Silver
Three Roads To Quantum Gravity	Lee Smolin
The Drunkard's Walk	Leonard Mlodinow
Six Impossible Things Before Breakfast	Lewis Wolpert
On Certainty	Ludwig Wittgenstein
Philosophical Grammar	Ludwig Wittgenstein
Tractatus Logico-Philosophicus	Ludwig Wittgenstein
Gandhi An Autobiography: The Story of My Experiments With Truth	Mahatma Gandhi
Islam in the World	Malise Ruthven
Evilicious	Marc Hauser
Moral Minds	Marc Hauser
Mirroring People	Marco Iacoboni
Letters From The Earth	Mark Twain
What Is Man? And Other Essays	Mark Twain
The Holocaust: A History of the Jews of Europe During the Second World War	Martin Gilbert
Our Final Hour	Martin Rees
Daily Rituals: How Artists Work	Mason Currey
Genome	Matt Ridley
The Primacy of Perception	Maurice Merleau-Ponty
Where Is Science Going? 	Max Planck
Our Mathematical Universe	Max Tegmark
Economy and Society	Max Weber
The Ethical Brain	Michael Gazzaniga
Who’s In Charge? Free Will and the Science of the Brain	Michael Gazzaniga
Why Darwin Matters	Michael Shermer
The Anatomy of Evil	Michael Stone
Discipline & Punish: The Birth of the Prison	Michel Foucault
Kingdom Coming	Michelle Goldberg
The Nature of Consciousness	Ned Block
Neuroethics	Neil Levy
Swami Prabhavananda	Niall Shanks
A History of the Mind	Nicholas Humphrey
The Koran	NJ Dawood
Europe: A History	Norman Davies
The Heart of Buddhist Meditation	Nyanaponika Thera
An Anthropologist on Mars	Oliver Sacks
The Man Who Mistook His Wife For A Hat	Oliver Sacks
The Kingdom of Auschwitz: 1940-1945	Otto Freidrich
The Really Hard Problem: Meaning in a Material World	Owen Flanagan
Religion Explained	Pascal Boyer
Terror and Liberalism	Paul Berman
Just Babies	Paul Bloom
When Time Shall Be No More	Paul Boyer
Into the Silent Land	Paul Broks
Matter and Consciousness: A Contemporary Introduction to the Philosophy of Mind	Paul Churchland
Scientific Realism and the Plasticity of Mind	Paul Churchland
The Engine of Reason	Paul Churchland
Higher Superstition	Paul Gross
History of Christianity	Paul Johnson
The Life You Can Save	Peter Singer
Writings on an Ethical Life	Peter Singer
Living High and Letting Die	Peter Unger
The Symposium	Plato
Porphyry's Against the Christians	Porphyry
The Drowned and the Saved	Primo Levi
The Periodic Table	Primo Levi
The Nonsense of Free Will	R. T. Oerton
The Age of Spiritual Machines	Ray Kurzweil
Bertrand Russell	Ray Monk
Ludwig Wittgenstein	Ray Monk
A Devil’s Chaplain	Richard Dawkins
Climbing Mount Improbable	Richard Dawkins
The God Delusion	Richard Dawkins
The Selfish Gene	Richard Dawkins
Six Not-So-Easy Pieces	Richard Feynman
The Character of Physical Law	Richard Feynman
The Feynman Lectures on Physics: The Definitive and Extended Edition	Richard Feynman
The Oxford Companion to the Mind	Richard L. Gregory
Consequences Of Pragmatism	Richard Rorty
Mapping the Mind	Rita Carter
On Being Certain	Robert Burton
The Anatomy of Melancholy	Robert Burton
Without Conscience	Robert D. Hare
Brighter than a Thousand Suns	Robert Jungk
The Ends of the Earth	Robert Kaplan
Anarchy, State, and Utopia	Robert Nozick
Natural Selection and Social Theory	Robert Trivers
I of the Vortex	Rodolfo R. Llinas
Shadows of the Mind	Roger Penrose
The Emperor's New Mind	Roger Penrose
The Large, the Small and the Human Mind	Roger Penrose
Ethics for the Real World	Ronald Howard
Patterns of Culture	Ruth Benedict
Joseph Anton: A Memoir	Salman Rushdie
A Companion to the Philosphy of the Mind	Samuel Guttenplan
The Clash of Civilizations	Samuel Huntington
WAR	Sebastian Junger
How We Die	Sherwin B. Nuland
The Future of an Illusion	Sigmund Freud
Mind-Blindness	Simon Baron Cohen
The Science of Evil	Simon Baron Cohen
The Book of Dead Philosophers	Simon Critchley
The Professor and the Madman	Simon Winchester
Lying	Sissela Bok
Sleep Thieves	Stanley Coren
Buddhism without Beliefs	Stephen Batchelor
How the Mind Works	Steven Pinker
The Blank Slate	Steven Pinker
The Art Of War	Sun Tzu
Conversations on Consciousness	Susan Blackmore
Shankara's Crest Jewel of Discrimination	Swami Prabhavananda
Seven Pillars of Wisdom	TE Lawrence
Food of the Gods	Terence McKenna
True Hallucinations	Terence McKenna
Perfect Soldiers	Terry McDermott
The Heart of Awareness: A Translation of the Ashtavakra Gita	Thomas Byrom
Leviathan	Thomas Hobbes
The Structure of Scientific Revolutions	Thomas Kuhn
Being No One	Thomas Metzinger
Neural Correlates of Consciousness	Thomas Metzinger
Other Minds	Thomas Nagel
The Last Word	Thomas Nagel
King James Study Bible	Thomas Nelson
What's God Got to Do with It?	Tim Page
Altered Egos: How the Brain Creates the Self	Todd Feinberg
The User Illusion	Tor Norretranders
In Cold Blood	Truman Capote
Central Philosophy of Buddhism	TRV Murti
Quintessential Dzogchen	Tulku Urgyen Rinpoche
Average Is Over	Tyler Cowen
Phantoms in the Brain	V. S. Ramachandran
God: The Failed Hypothesis	Victor Stenger
Among the Believers	VS Naipaul
The Portable Nietzsche	Walter Kaufmann
Open Secret	Wei Wei Wu Wei
Self-Contradictions of the Bible	William Burr
Eye for an Eye	William Ian Miller
Faking It	William Ian Miller
Humiliation	William Ian Miller
The Anatomy of Disgust	William Ian Miller
Essays in Radical Empiricism 	William James
The Principles of Psychology	William James
Labyrinths of Reason	William Poundstone
Prisoner's Dilemma	William Poundstone
Companion to Clinical Neurology	William Pryse-Phillips
Darkness Visible	William Styron
The Quotable Hitchens	Windsor Mann
Faith at War	Yaroslav Trofimov
Eurabia	Ye'or Bat
The Atheist’s Guide to Reality: Enjoying Life Without Illusions	Alexander Rosenberg
Trespassing on Einstein’s Lawn: A Father, a Daughter, the Meaning of Nothing, and the Beginning of Everything	Amanda Gefter
Self Comes to Mind: Constructing the Conscious Brain	Antonio Damasio
The Fabric of the Cosmos: Space, Time, and the Texture of Reality	Brian Greene
Physicalism and Its Discontents	Carl Gillett
The Demon-Haunted World: Science as a Candle in the Dark	Carl Sagan
Mistakes Were Made	Carol Tavris
Why Information Grows: The Evolution of Order, from Atoms to Economies	Cesar Hidalgo
A Better Life: 100 Atheists Speak Out on Joy & Meaning in a World Without God	Chris Johnson
Predictably Irrational: The Hidden Forces that Shape Our Decisions	Dan Ariely
Consciousness Explained	Daniel Dennett
Darwin’s Dangerous Idea: Evolution and the Meanings of Life	Daniel Dennett
Intuition Pumps and Other Tools for Thinking	Daniel Dennett
Time and Chance	David Albert
The Fabric of Reality: The Science of Parallel Universes and Its Implications	David Deutsch
Incognito: The Secret Lives of the Brain	David Eagleman
The Emergent Multiverse: Quantum Theory According to the Everett Interpretation	David Wallace
The Conscious Mind: In Search of a Fundamental Theory	DJ Chalmers
Cells to Civilizations: The Principles of Change that Shape Life	Enrico Coen
The Meaning of Human Existence	EO Wilson
Does Santa Exist? A Philosophical Investigation	Eric Kaplan
The Five Ages of the Universe: Inside the Physics of Eternity	Fred Adams
Spooky Action at a Distance: The Phenomenon That Reimagines Space and Time–and What It Means for Black Holes, the Big Bang, and Theories of Everything	George Musser
Phi: A Voyage from the Brain to the Soul	Giulio Tononi
Good Without God: What a Billion Nonreligious People Do Believe	Greg Epstein
Constructivism in Practical Philosophy	James Lenman
Why Evolution Is True	Jerry Coyne
Why Does the World Exist	Jim Holt
The Storytelling Animal: How Stories Make Us Human	Jonathan Gottschall
Moral Tribes: Emotion, Reason, and the Gap Between Us and Them	Joshua Greene
Knocking on Heaven’s Door: How Physics and Scientific Thinking Illuminate the Universe and the Modern World	Lisa Randall
The Call of Character: Living a Life Worth Living	Mari Ruti
Complexity: A Guided Tour	Melanie Mitchell
Who’s In Charge? Free Will and the Science of the Brain	Michael Gazzaniga
The Signal and the Noise: Why So Many Predictions Fail	Nate Silver
Your Inner Fish: A Journey into the 3	Neil Shubin
The Vital Question: Energy, Evolution, and the Origins of Complex Life	Nick Lane
The Really Hard Problem: Meaning in a Material World	Owen Flanagan
Touching a Nerve: The Self as Brain	Patricia Churchland
How Nature Works: The Science of Self-Organized Criticality	Per Bak
The Shadow of Consciousness	Peter Hankins
Life’s Ratchet: How Molecular Machines Extract Order from Chaos	Peter Hoffman
The Ethical Project	Philip Kitcher
The Character of Physical Law	Richard Feynman
Quantum Computing Since Democritus	Scott Aaronson
The Grand Design	Stephen Hawking
To Explain the World: The Discovery of Modern Science	Steven Weinberg
A Significant Life: Human Meaning in a Silent Universe	Todd May
A Dialogue on Consciousness	Torin Halter
Debt: The First 5,000 Years	David Graeber
Finite and Infinite Games	James Carse
New Rules for the New Economy	Kevin Kelly
The Republic of Tea	Mel Ziegler
Just Kids	Patti Smith
The Art of Possibility	Rosamund Stone Zander
The War of Art	Steve Pressfield
Do the Work	Steve Pressfield
Zig Ziglar’s Secrets of Closing the Sale	Zig Ziglar
See You at the Top	Zig Ziglar
Makers: The New Industrial Revolution	Chris Anderson
Little Brother	Cory Doctorow
Snow Crash	Neal Stephenson
Understanding Comics: The Invisible Art	Scott McCloud
Diamond Age: Or, A Young Lady's Illustrated Primer	Neal Stephenson
A Hundred Years of Solitude	Gabriel Garcia Marquez
Iliad	Homer
The Discovery of India	Jawaharlal Nehru
The Mahabharata	Vyasa
Meditations	Marcus Aurelius
Autobiography of a Yogi	Paramahansa Yogananda
The Book of Laughter and Forgetting	Milan Kundera
The Saga of Khassak	OV Vijayan
Professor Romeo	Ann Bernays
The Family Tree 	Carole Cadwalladr
Problems in Philosophy	Colin McGinn
Thinks ...	David Lodge
One, Two, Three ... Infinity	George Gamow
Enemies, A Love Story	Isaac Singer
A History of Force	James Payne
The Nurture Assumption	Judith Rich Harris
Huckleberry Finn	Mark Twain
The Tin Men 	Michael Frayn
The Mind-Body Problem	Rebecca Goldstein
The Selfish Gene	Richard Dawkins
Brain Storm	Richard Dooling
The Careful Writer	Theodore Bernstein
The Last Word	Thomas Nagel
The Strategy of Conflict	Thomas Schelling
Brazzaville Beach	William Boyd
Moby Dick	Herman Melville
The History of the Decline and Fall of the Roman Empire	Edward Gibbon
Philosophical Letters	Francois Voltaire
The Birth and Death of the Sun	George Gamow
The Mysterious Universe	James Jeans
Warped Passages	Lisa Randall
The Selfish Gene	Richard Dawkins
The Character of Physical Law	Richard Feynman
On a Piece of Chalk	Thomas Huxley
The Whole Shebang	Timothy Ferris
Science and Sanity	Alfred Korzybski
Islandia	Austin Tappan Wright
The Unix Programming Environment	Brian Kernighan
The Innovator's Dilemma	Clayton Christensen
Dune	Frank Herbert
Built to Last	James Collins
The Meaning of Culture	John Cowper Powys
An Introduction to Realistic Philosophy	John Wild
Code and Other Laws of Cyberspace	Lawrence Lessig
Rasselas	Samuel Johnson
The Structure of Scientific Revolutions	Thomas Kuhn
The Palm at the End of the Mind	Wallace Stevens
On Writing Well	William Zinsser
Tubes: A Journey to the Center of the Internet	Andrew Blum
Makers: The New Industrial Revolution	Chris Anderson
Automate This: How Algorithms Came to Rule Our World	Christopher Steiner
Better, Stronger, Faster: The Myth of American Decline…and the Growth of a New Economy	Daniel Gross
Fast Future: How the Millennial Generation is Shaping the World	David Burstein
Social Business By Design: Transformative Social Media Strategies for the Connected Company	Dion Hinchcliffe
Present Shock: When Everything Happens Now	Douglas Rushkoff
Nanotechnology for Dummies	Earl Boysen
Robot Futures	Ellah Reza Bourbakhsh
The Lean Startup: How Today’s Entrepreneurs Use Continuous Innovation to Create Radically Successful Businesses	Eric Ries
Predictive Analytics: The Power to Predict Who Will Click, Buy, Lie, or Die	Eric Siegel
Rewire: Digital Cosmopolitans in the Age of Connection	Ethan Zuckerman
Wait: The Art and Science of Delay	Frank Partnoy
Knowledge and Power: The Information Theory of Capitalism and How it is Revolutionizing Our World	George Gilder
Open Services Innovation: Rethinking Your Business to Grow and Compete in a New Era	Henry Chesbrough
Reality is Broken: Why Games Make Us Better and How They Can Change the World	Jane McGonigal
You Are Not a Gadget: A Manifesto	Jaron Lanier
Conscious Capitalism: Liberating the Heroic Spirit of Business	John Mackey
For the Win: How Game Thinking Can Revolutionize Your Business	Kevin Werbach
The Shareholder Value Myth: How Putting Shareholders First Harms Investors, Corporations, and the Public	Lynn Stout
What You Can Change…And What You Can’t: The Complete Guide to Successful Self Improvement	Martin Seligman
The Future Arrived Yesterday: The Rise of the Protean Corporation and What It Means for You	Michael Malone
Antifragile: Things That Gain from Disorder	Nassim Taleb
Fooled by Randomness: The Hidden Role of Change in Life and in the Markets	Nassim Taleb
Addiction by Design: Machine Gambling in Las Vegas	Natasha Dow Schull
The Signal and the Noise: Why So Many Predictions Fail	Nate Silver
Fab: The Coming Revolution on Your Desktop	Neil Gershenfeld
Wired for War: The Robotics Revolution and Conflict in the Twenty-first Century	P.W. Singer
The Org: The Underlying Logic of the Office	Ray Fisman
How to Create a Mind: The Secret of Human Thought Revealed	Ray Kurzweil
Cyber War: The Next Threat to National Security and What to Do About It	Richard A. Clarke
The Rise of the Creative Class	Richard Florida
Everything Bad is Good For You: How Today’s Popular Culture is Actually Making Us Smarter	Steven Johnson
Quiet: The Power of Introverts in a World That Can’t Stop Talking	Susan Cain
Extra Lives: Why Video Games Matter	Tom Bissell
The Power of Co-Creation: Build it With Them to Boost Growth, Productivity, and Profits	Venkat Ramaswamy
Big Data	Viktor Mayer-Schonberger
Employees First, Customers Second: Turning Conventional Management Upside Down	Vineet Nayar
Lords of Strategy: The Secret History of the New Corporate World	Walter Kiechel
Three Day Road	Joseph Boyden
Good-Bye to All That	Robert Graves
Birdsong	Sebastian Faulks
Seven Pillars of Wisdom	TE Lawrence
Testament of Youth	Vera Brittain